1111111111111111111111111111111111
1000000000000000111000000000000001
10P0000000000000001000000000000001
1000000111100001111111110000000001
1000000000000000001000001111000001
1000000000000100000000000001000001
1000000111111100000000000001000001
1010000000000100000000000001000001
1010000000000000000000000000000001
1001100000000000000000000000010001
1000110000000000000000000000111001
1000011000000000001110000000010001
1001111110000000001100000000000001
1000000000000000001110000000000001
1000000000000000000101000000000001
1000000000000011111101000000000001
1011000000000000000001000000000001
100100000000000000111100000000CE01
1001000000000000000000000000000001
1111111111111111111111111111111111
